0
19
0
13
00000000000000000000
01111111100011111110
01000000000000000010
01000000000000000010
01000000000000000010
01000000000000000010
00000000000000000000
00000000000000000000
01000000000000000010
01000000000000000010
01000000000000000010
01000000000000000010
01000000000000000010
01111111111111111110
