-18
20
-8
9
000000000000000000000000000000000000000
111111111111111111111111111111111111110
100000000000000000000000000000000000010
100000000000000000000000000000000000010
100000000000000000000000000000000000010
100000000000000000000000000000000000010
100000000000000000000011111110000000010
100000000000000000000011111110000000010
100000000001000000000011111110000000010
100000000000000000000011111110000000010
100000000000000000000011111110000000010
100000001000100000000011111110000000010
100000000000000000000011111110000000010
100000000000000000000000000000000000010
100000000000000000000000000000000000010
100000000000000000000000000000000000010
100000000000000000000000000000000000010
111111111111111111111111111111111111110
