0
17
0
14
000000000000000000
111111111111111110
100000000000001110
100000000000001110
100000000000001110
100000000000011110
000000000000011110
000000000000000010
000000000000000010
100000000000000010
100000000000000010
100000000000000010
100000000000000010
100000000000000010
111111111111111110
