-18
20
-8
9
000000000000000000000000000000
000000000000000000000000000000
000000000000000000000000000000
000000000000000000000000000000
000000000000000000000000000000
000000000000000000000000000000
000000000000000000000011111110
000000000000000000000011111110
000000000001000000000011111110
000000000000000000000011111110
000000000000000000000011111110
000000001000100000000011111110
000000000000000000000011111110
000000000000000000000000000000
