-10
11
-4
4
0000000000000000000000
0000000000000011111110
0000000000000011111110
0001000000000011111110
0000000000000011111110
0000000000000011111110
1000100000000011111110
0000000000000011111110
0000000000000000000000
